*************************************************************
*O  *     *       *             *       *   *               * 
**  * *** * **  *** ****  ***** * * **  * * *  ***  ******  * 
*   * * * * *   *   *     *   * * * *   * *     *   * *     * 
*  ** * * * *  **  ** ***** * * *** * *** ******* *** * ***** 
*     *   * *       * *   * *   *   * *   * *     *     *   * 
******* *** ********* * * * ***** *** *  ** *  ****  ****  ** 
*     * *   * *       * *         * * *     *     *     *   * 
* *  ** *** * * ******************* * ***** ****  ***** *** * 
* *   *   *   * *       *     *   *   *   * *     *   *   * * 
****  *** ***** *  **** *  ** *  **  ** * * * ***** * *** * * 
*       *     * *     *     * *   *   * *   * *     * * *   * 
* ****  ****  * ***** ******* **  *** ******* * **  * * **  * 
* *       *   *     *   *     *     *   *     * *   *   *   * 
* ********* *** **  **  * ***** *** *** * ******* ***** * *** 
* *         *   *   *   * *     * *   *   *       *   * * * * 
* * *********** *  ** *** * **  * **  ******  ******* * * * * 
* * *         * *     *   * *   *       *     *     *   * * * 
* * ******  * ********* *** *  ********** *  **  ** ***** * * 
*           *           *   *             *       *        X*
************************************************************* 
