**********
*   *   X*
*   *    *
*        *
*   ******
*        *
*        *
*        *
*O       *
**********
