*****
*   *
*** *
*   *
*** *
*   *
*** *
*   *
*** *
*   *
*** *
*   *
*** *
*   *
*** *
*   *
*** *
*   *
*** *
*   *
*** *
*   *
*** *
*X O*
*****
