**********
*        *
* ** * *O*
*    * ***
*    * *X*
**** *** *
*      * *
* *** ** *
* *      *
**********
