**********
*       X*
*        *
*        *
*        *
*        *
*        *
*        *
*O       *
**********
